!!ATOK_TANGO_TEXT_HEADER_1
!!キャラクター
かつらぎあまね	葛城天音	固有人名
いちのせとうこ	一ノ瀬透子	固有人名
かぐらゆずき	神楽柚希	固有人名
しいくらももか	椎倉百花	固有人名
ももか	百花	固有人名
しいくらちとせ	椎倉千歳	固有人名
しいくらまき	椎倉万季	固有人名
まき	万季	固有人名
あいざわみつる	逢沢光流	固有人名
さがやまりく	嵯峨山陸	固有人名
みさきあれくしす	岬アレクシス	固有人名
はるないちと	春名一斗	固有人名
あんなりんどばーぐ	杏菜・リンドバーグ	固有人名
あんな	杏菜	固有人名
うのあんな	宇野杏菜	固有人名
かがみありす	加賀美ありす	固有人名
おさらぎすずか	大佛涼花	固有人名
かーみら	カーミラ	固有人名
かとうみら	加藤美羅	固有人名
はるみしの	晴海詩乃	固有人名
ゆうさかせいら	由羽坂星良	固有人名
ひめのみゆき	姫野美雪	固有人名
つるまきさよこ	鶴巻小夜子	固有人名
さよこ	小夜子	固有人名
ねこやしきなつめ	猫屋敷棗	固有人名
まるけす	マルケス	固有人名
ななせみはる	七瀬深春	固有人名
みはる	深春	固有人名
しののめうめ	東雲うめ	固有人名
ことひらさくら	琴平さくら	固有人名
あかみねななみ	赤嶺七海	固有人名
かたがせりな	片ヶ瀬理名	固有人名
あかね	茜	固有人名
あおい	葵	固有人名
なでぃふぁ	ナディファ	固有人名
なぎさつぐみ	凪沙つぐみ	固有人名
みるるる	みるるる～＊	固有人名
みくりやるみ	御厨るみ	固有人名
しんぎょうじりおり	真行寺里織	固有人名
りおり	里織	固有人名
ときこさーど	トキコⅢ	固有人名
ときこ	トキコⅢ	固有人名
さくらのみどり	桜野みどり	固有人名
まがみきょうこ	真神匡子	固有人名
あんどうかずみ	安東数美	固有人名
きよみやいつき	清宮一樹	固有人名
きなりくれは	鬼無里呉葉	固有人名
こんごうちあきな	金剛地椛奈	固有人名
アビゲイル	アビゲイル・A・ミラー	固有人名
りんしゃおふぇい	林小菲	固有人名
ひしみさおり	菱見沙織	固有人名
だんまさき	旦柾	固有人名
みたまいや	三田舞夜	固有人名
とりすちひろ	鳥栖智尋	固有人名
むとうさき	武藤咲	固有人名
おざきえりか	尾崎恵梨香	固有人名
いたがきゆいの	板垣友以乃	固有人名
たかおめい	高尾芽以	固有人名
わかつきるりあ	若槻瑠璃亜	固有人名
たきがわあき	滝川亜希	固有人名
はたなかさゆり	畠中小百合	固有人名
おかやまゆい	岡山結衣	固有人名
あいはらななせ	相原七星	固有人名
ふくしまお	福士麻緒	固有人名
きどりょう	城戸涼	固有人名
ふじもりいくえ	藤森郁恵	固有人名
やながわともか	柳川智花	固有人名
はしづめはるか	橋爪遥	固有人名
すがよしの	須賀佳乃	固有人名
たきがわれいな	多岐川麗奈	固有人名
くさかべみほ	日下部美穂	固有人名
おがさわらともか	小笠原朝香	固有人名
!!ユニット名
まいすたー	MySTAR	固有人名
らでぃっしゅ	Radish	固有人名
ぷてぃぐらん	PetitetGrand	固有人名
りゃなそん	りゃなそん	固有人名
くあんたむ	QuantumEVE	固有人名
くあんたむいう゛	QuantumEVE	固有人名
とらんぷ	TRAMP	固有人名
!!声優
みむらゆうな	三村ゆうな	固有人名
はしもとゆい	橋本結	固有人名
ゆうきかな	優木かな	固有人名
はしあふみ	土師亜文	固有人名
よしなりゆき	吉成由貴	固有人名
かとうさやか	加藤さやか	固有人名
やましただいき	山下大輝	固有人名
ふかまちとしなり	深町寿成	固有人名
こんのせいいちろう	近野誠一郎	固有人名
うめはらゆういちろう	梅原裕一郎	固有人名
もりやきょうか	守屋亨香	固有人名
ななひら	ななひら	固有人名
いしぐろちひろ	石黒千尋	固有人名
たいちよう	大地葉	固有人名
かわにしゆうこ	川西ゆうこ	固有人名
よしいあやみ	吉井彩実	固有人名
みやもとゆめ	宮本侑芽	固有人名
みおのせいら	澪乃せいら	固有人名
おのさき	小野早稀	固有人名
とりべまりこ	鳥部万里子	固有人名
ほんだまりこ	本多真梨子	固有人名
にいなあやの	新名彩乃	固有人名
ひのろい	日野ろい	固有人名
やまぐちりえ	山口理恵	固有人名
よしだあこ	吉田亜子	固有人名
やまぐちたかこ	山口貴子	固有人名
やまのひとみ	山野瞳	固有人名
きたなつき	北奈つき	固有人名
ちかむらのぞみ	近村望実	固有人名
ここんここ	小紺ココ	固有人名
あらかわちか	荒川ちか	固有人名
